#This is a simple test
#SIZEX=20
#SIZEY=20
00000000000000000000
0.....0............0
0..X..0............0
0....*0............0
000.0000...........0
0*.....0...........0
0...........*0.....0
0**....0..........*0
000.000000...0000000
0..................0
0..................0
0..................0
0..................0
0..................0
0..................0
0..................0
0..................0
0..................0
0..................0
00000000000000000000
#END
